0000000000000000000000000000000000000000000000000000000000000
0000000000000000000000000000000000000000000000000000000000000
0000000000000000000000000000000000000000000000000000000000000
0000000000000000000000000000000000000000000000000000000000000
0000000000000000000000000000000000000000000000000000000000000
0000000000000000000000000000000000000000000000000000000000000
0000000000000000000000000000000000000000000000000000000000000
0000000000000000000000000000000000000000000000000000000000000
0000000000000000000000000000000000000000000000000000000000000
0000000000000000000000000000000000000000000000000000000000000
0000000000000000000000000000000000000000000000000000000000000
0000000000000000000000000000000000000000000000000000000000000
0000000000000000000000000000000000000000000000000000000000000
0000000000000000000000000000000000000000000000000000000000000
0000000000000000000000000000000000000000000000000000000000000
0000000000000000000000000000000000000000000000000000000000000
0000000000000000000000000000000000000000000000000000000000000
0000000000000000000000000000000000000000000000000000000000000
0000000000000000000000000000000000000000000000000000000000000
0000000000000000000000000000000000000000000000000000000000000
0000000000000000000000000000000000000000000000000000000000000
0000000000000000000000000000000000000000000000000000000000000
0000000000000000000000000000000000000000000000000000000000000
0000000000000000000000000000000000000000000000000000000000000
0000000000000000000000000000000000000000000000000000000000000
0000000000000000000000000000000000000000000000000000000000000
0000000000000000000000000000000000000000000000000000000000000
0000000000000000000000000000000000000000000000000000000000000
0000000000000000000000000000000000000000000000000000000000000
0000000000000000000000000000000000000000000000000000000000000
0000000000000000000000000000000000000000000000000000000000000
0000000000000000000000000000000000000000000000000000000000000
0000000000000000000000000000000000000000000000000000000000000
0000000000000000000000000000000000000000000000000000000000000
0000000000000000000000000000000000000000000000000000000000000
0000000000000000000000000000000000000000000000000000000000000
0000000000000000000000000000000000001111111110000000111111111
0000000000000000000000000000000000010000000001000000100000001
0000000000000000000000000000000000100000000000100000100000001
0000000000000000000000000000000001000000000000010000100000001
0000000000000000000000000000000010000000000000001000100000001
0000000000000000000000000000000100000000000000000100100000001
0000000000000000000000000000001000000000000000000010100000001
0000000000000000000000000000010000000000000000000001100000001
0000000000000000000000000000100000003000000000000000100000001
0000000000000000000000000000100000000000000000000000000000001
0000000000000000000000000000100000000000000000000000000000001
0000000000000000000000000000100000000000000000000000000000001
0000000000000000000000000000100000000000000000000000000000001
0000000000000000000000000000100000000000000000000000000000001
0000000000000000000000000000100000000000000000000000000000001
0000000000000000000000000000100000000000000000000000000000001
0000000000000000000000000000100000003444444434444444300000001
0000000000000000000000000000100000004444444444444444000000001
0000000000000000000000000000100000004444444444444440000000001
0000000000000000000000000000100000004444444444444400000000001
0000000000000000000000000000100000004444444444444000000000001
0000000000000000000000000000100000004444444444440000000000001
0000000000000000000000000000100000004444444444400000000000001
0000000000000000000000000000100000004444444444000000000000001
0000000000000000000000000000100000004444444430000000111111111
0000000000000000000000000000010000000000000000000001000000000
0000000000000000000000000000001000000000000000000010000000000
0000000000000000000000000000000100000000000000000100000000000
0000000000000000000000000000000010000000000000001000000000000
0000000000000000000000000000000001000000000000010000000000000
0000000000000000000000000000000000100000000000100000000000000
0000000000000000000000000000000000010000000001000000000000000
0000000000000000000000000000000000001111111110000000000000000
