6666666666666666666666666666666666666666666661
6666666666666666666666666666666666666666666666
6666666666666666666666666666666666666666666666
6666666666666666666666666666666666666666666666
6666666666666666666666666666666666666666666666
6666666666666666666666666666666666666666666666
6666666666666666666666666666666666666666666666
6666666666666666666666666666666666666666666666
6666666666666666666666666666666666666666666666
6666666666666666666666666666666666666666666666
6666666666666666666666666666666666666666666666
6666666666666666666666666666666666666666666666
6666666666666661666661111111666666666661111111
6666666666666610166661000001666666666610000001
6666666666666100016661000001666666666100000001
6666666666661000001661000001666666661000000001
6666666666610000000161000001666666610000000001
6666666666100000000011000001666666100000000001
6666666661000000000001000001111111000000000001
6666666661000000000000000000000000000000000016
6666666661000000000000000000000000000000000166
6666666661000000000000000000000000000000001666
6666666661000000000000000000000000000000016666
6666666661000000000000000000000000000000166666
6666666661000000000001111111111111000001111111
6666666661000000000044100000000010000000000001
6666666661000000000444410000000100000000000001
6666666661000000004444441000001000000000000001
6666666661000000044444444100010000000000000001
6666666661000000444444444410100000000000000001
6666666661000004444443444441000000000000000001
6666666661000044444444444410000000000000000001
6666666661000444444444444100000000000000000001
6666666661004444444444441000000000000000000001
6666666661044444444444410000000000000000000001
6666666661444444444444100000000000000000000001
6666666661111111111111000005000001111111111111
6666666666666666666666100000000016666666666666
6666666666666666666666610000000166666666666666
6666666666666666666666661000001666666666666666
6666666666666666666666666100016666666666666666
6666666666666666666666666610166666666666666666
6666666666666666666666666661666666666666666666
6666666666666666666666666666666666666666666666
6666666666666666666666666666666666666666666666
6666666666666666666666666666666666666666666666
6666666666666666666666666666666666666666666666
6666666666666666666666666666666666666666666666
6666666666666666666666666666666666666666666666
6666666666666666666666666666666666666666666666
6666666666666666666666666666666666666666666666
6666666666666666666666666666666666666666666666
