6666666666666666666666666666666666666666666666666666666666666
6666666666666666666666666666666666666666666666666666666666666
6666666666666666666666666666666666666666666666666666666666666
6666666666666666666666666666666666666666666666666666666666666
6666666666666666666666666666666666666666666666666666666666666
6666666666666666666666666666666666666666666666666666666666666
6666666666666666666666666666666666666666666666666666666666666
6666666666666666666666666666666666666666666666666666666666666
6666666666666666666666666666666666666666666666666666666666666
6666666666666666666666666666666666666666666666666666666666666
6666666666666666666666666666666666666666666666666666666666666
6666666666666666666666666666666666666666666666666666666666666
6666666666666666666666666666666666666666666666666666666666666
6666666666666666666666666666666666666666666666666666666666666
6666666666666666666666666666666666666666666666666666666666666
6666666666666666666666666666666666666666666666666666666666666
6666666666666666666666666666666666666666666666666666666666666
6666666666666666666666666666666666666666666666666666666666666
6666666666666666666666666666666666666666666666666666666666666
6666666666666666666666666666666666666666666666666666666666666
6666666666666666666666666666666666666666666666666666666666666
6666666666666666666666666666666666666666666666666666666666666
6666666666666666666666666666666666666666666666666666666666666
6666666666666666666666666666666666666666666666666666666666666
6666666666666666666666666666666666666666666666666666666666666
6666666666666666666666666666666666666666666666666666666666666
6666666666666666666666666666666666666666666666666666666666666
6666666666666666666666666666666666666666666666666666666666666
6666666666666666666666666666666666666666666666666666666666666
6666666666666666666666666666666666666666666666666666666666666
6666666666666666666666666666666666666666666666666666666666666
6666666666666666666666666666666666666666666666666666666666666
6666666666666666666666666666666666666666666666666666666666666
6666666666666666666666666666666666666666666666666666666666666
6666666666666666666666666666666666666666666666666666666666666
6666666666666666666666666666666666666666666666666666666666666
6666666666666666666666666666666666661111111116666666111111111
6666666666666666666666666666666666610000000001666666100000001
6666666666666666666666666666666666100000000000166666100000001
6666666666666666666666666666666661000000000000016666100000001
6666666666666666666666666666666610000000000000001666100000001
6666666666666666666666666666666100000000000000000166100000001
6666666666666666666666666666661000000000000000000016100000001
6666666666666666666666666666610000000000000000000001100000001
6666666666666666666666666666100000003000000050000000100000001
6666666666666666666666666666100000000000000000000000000000001
6666666666666666666666666666100000000000000000000000000000001
6666666666666666666666666666100000000000000000000000000000001
6666666666666666666666666666100000000000000000000000000000001
6666666666666666666666666666100000000000000000000000000000001
6666666666666666666666666666100000000000000000000000000000001
6666666666666666666666666666100000000000000000000000000000001
6666666666666666666666666666100000003444444434444444300000001
6666666666666666666666666666100000004000000000000004000000001
6666666666666666666666666666100000004000000000000040000000001
6666666666666666666666666666100000004000000000000400000000001
6666666666666666666666666666100000004000000000004000000000001
6666666666666666666666666666100000004000000000040000000000001
6666666666666666666666666666100000004000000000400000000000001
6666666666666666666666666666100000004000000004000000000000001
6666666666666666666666666666100000004444444430000000111111111
6666666666666666666666666666610000000000000000000001666666666
6666666666666666666666666666661000000000000000000016666666666
6666666666666666666666666666666100000000000000000166666666666
6666666666666666666666666666666610000000000000001666666666666
6666666666666666666666666666666661000000000000016666666666666
6666666666666666666666666666666666100000000000166666666666666
6666666666666666666666666666666666610000000001666666666666666
6666666666666666666666666666666666661111111116666666666666666
