L,4,2
H,6,1,2,2,3,3,4,4,3,3,2,2,2
W,7,8,7,8
W,1,3,1,2
W,1,4,1,3
W,1,5,1,4
W,2,6,1,5
W,2,6,3,5
W,3,5,3,6
W,3,6,4,6
W,1,2,2,2
W,2,2,3,2
W,3,2,4,1
W,4,1,5,2
W,5,2,6,2
W,6,2,7,2
W,7,2,7,3
W,7,3,7,4
W,7,4,6,4
W,6,4,7,5
W,7,5,7,6
W,7,6,6,6
W,6,6,5,5
W,5,5,5,5
W,4,5,5,5
W,4,5,4,6
W,3,2,4,3
W,4,3,5,4
W,5,4,4,4
W,4,4,3,4
W,3,4,4,4
W,3,4,4,3
S,3,3,R,R,R