W,0,1,2,1
W,2,1,3,0
W,3,0,4,0
W,4,0,5,1
W,5,1,5,5
W,5,5,4,6
W,4,6,2,6
W,2,6,2,5
W,2,5,1,6
W,1,6,0,6
P,0,6,0,5
W,0,5,1,4
W,1,4,0,3
P,0,3,0,1

W,2,2,3,2
W,3,2,3,3
W,3,3,2,3
W,2,3,2,2

W,3,4,4,4
W,4,4,3,5
W,3,5,3,4

S,1,2,R,R,G
S,4,1,G,G,G
S,1,5,G,R,R
S,4,3,G,R,R
S,4,5,R,G,R

H,4,2,5,3,5,4,6,2,6

L,3,1
