6666666666666666666666666666666666661666666666666666666666661111111111111111111111111666666666666666666666666666666666666666666666661111111111111111111111111
6666666666666666666666666666666666610166666666666666666666661000000000000000000000001666666666666666666666666666666666666666666666610000000000000000000000001
6666666666666666666666666666666666100016666666666666666666661000000000000000000000001666666666666666666666666666666666666666666666100000000000000000000000001
6666666666666666666666666666666661000001666666666666666666661000000000000000000000001666666666666666666666666666666666666666666661000000000000000000000000001
6666666666666666666666666666666610000000166666666666666666661000000000000000000000001666666666666666666666666666666666666666666610000000000000000000000000001
6666666666666666666666666666666100000000016666666666666666661000000000000000000000001666666666666666666666666666666666666666666100000000000000000000000000001
6666666666666666666666666666661000000000001666666666666666661000000000000000000000001666666666666666666666666666666666666666661000000000000000000000000000001
6666666666666666666666666666610000000000000166666666666666661000000000000000000000001666666666666666666666666666666666666666610000000000000000000000000000001
6666666666666666666666666666100000000000000016666666666666661000000000000000000000001666666666666666666666666666666666666666100000000000000000000000000000001
6666666666666666666666666661000000000000000001666666666666661000000000000000000000001666666666666666666666666666666666666661000000000000000000000000000000001
6666666666666666666666666610000000000000000000166666666666661000000000000000000000001666666666666666666666666666666666666610000000000000000000000000000000001
6666666666666666666666666100000000000000000000016666666666661000000000000000000000001666666666666666666666666666666666666100000000000000000000000000000000001
6666666666666666666666661000000000000000000000001666666666661000000000000000000000001666666666666666666666666666666666661000000000000000000000000000000000001
6666666666666666666666610000000000000000000000000166666666661000000000000000000000001666666666666666666666666666666666610000000000000000000000000000000000001
6666666666666666666666100000000000000000000000000016666666661000000000000000000000001666666666666666666666666666666666100000000000000000000000000000000000001
6666666666666666666661000000000000000000000000000001666666661000000000000000000000001666666666666666666666666666666661000000000000000000000000000000000000001
6666666666666666666610000000000000000000000000000000166666661000000000000000000000001666666666666666666666666666666610000000000000000000000000000000000000001
6666666666666666666100000000000000000000000000000000016666661000000000000000000000001666666666666666666666666666666100000000000000000000000000000000000000001
6666666666666666661000000000000000000000000000000000001666661000000000000000000000001666666666666666666666666666661000000000000000000000000000000000000000001
6666666666666666610000000000000000000000000000000000000166661000000000000000000000001666666666666666666666666666610000000000000000000000000000000000000000001
6666666666666666100000000000000000000000000000000000000016661000000000000000000000001666666666666666666666666666100000000000000000000000000000000000000000001
6666666666666661000000000000000000000000000000000000000001661000000000000000000000001666666666666666666666666661000000000000000000000000000000000000000000001
6666666666666610000000000000000000000000000000000000000000161000000000000000000000001666666666666666666666666610000000000000000000000000000000000000000000001
6666666666666100000000000000000000000000000000000000000000011000000000000000000000001666666666666666666666666100000000000000000000000000000000000000000000001
6666666666661000000000000000000000000000000000000000000000001000000000000000000000001111111111111111111111111000000000000000000000000000000000000000000000001
6666666666661000000000000000000000000000000000000000000000000000000000000000000000000000000000000000000000000000000000000000000000000000000000000000000000016
6666666666661000000000000000000000000000000000000000000000000000000000000000000000000000000000000000000000000000000000000000000000000000000000000000000000166
6666666666661000000000000000000000000000000000000000000000000000000000000000000000000000000000000000000000000000000000000000000000000000000000000000000001666
6666666666661000000000000000000000000000000000000000000000000000000000000000000000000000000000000000000000000000000000000000000000000000000000000000000016666
6666666666661000000000000000000000000000000000000000000000000000000000000000000000000000000000000000000000000000000000000000000000000000000000000000000166666
6666666666661000000000000000000000000000000000000000000000000000000000000000000000000000000000000000000000000000000000000000000000000000000000000000001666666
6666666666661000000000000000000000000000000000000000000000000000000000000000000000000000000000000000000000000000000000000000000000000000000000000000016666666
6666666666661000000000000000000000000000000000000000000000000000000000000000000000000000000000000000000000000000000000000000000000000000000000000000166666666
6666666666661000000000000000000000000000000000000000000000000000000000000000000000000000000000000000000000000000000000000000000000000000000000000001666666666
6666666666661000000000000000000000000000000000000000000000000000000000000000000000000000000000000000000000000000000000000000000000000000000000000016666666666
6666666666661000000000000000000000000000000000000000000000000000000000000000000000000000000000000000000000000000000000000000000000000000000000000166666666666
6666666666661000000000000000000000000000000000000000000000000000000000000000000000000000000000000000000000000000000000000000000000000000000000001666666666666
6666666666661000000000000000000000000000000000000000000000000000000000000000000000000000000000000000000000000000000000000000000000000000000000016666666666666
6666666666661000000000000000000000000000000000000000000000000000000000000000000000000000000000000000000000000000000000000000000000000000000000166666666666666
6666666666661000000000000000000000000000000000000000000000000000000000000000000000000000000000000000000000000000000000000000000000000000000001666666666666666
6666666666661000000000000000000000000000000000000000000000000000000000000000000000000000000000000000000000000000000000000000000000000000000016666666666666666
6666666666661000000000000000000000000000000000000000000000000000000000000000000000000000000000000000000000000000000000000000000000000000000166666666666666666
6666666666661000000000000000000000000000000000000000000000000000000000000000000000000000000000000000000000000000000000000000000000000000001666666666666666666
6666666666661000000000000000000000000000000000000000000000000000000000000000000000000000000000000000000000000000000000000000000000000000016666666666666666666
6666666666661000000000000000000000000000000000000000000000000000000000000000000000000000000000000000000000000000000000000000000000000000166666666666666666666
6666666666661000000000000000000000000000000000000000000000000000000000000000000000000000000000000000000000000000000000000000000000000001666666666666666666666
6666666666661000000000000000000000000000000000000000000000000000000000000000000000000000000000000000000000000000000000000000000000000016666666666666666666666
6666666666661000000000000000000000000000000000000000000000000000000000000000000000000000000000000000000000000000000000000000000000000166666666666666666666666
6666666666661000000000000000000000000000000000000000000000001111111111111111111111111111111111111111111111111000000000000000000000001111111111111111111111111
6666666666661000000000000000000000000000000000000000000000044100000000000000000000000000000000000000000000010000000000000000000000000000000000000000000000001
6666666666661000000000000000000000000000000000000000000000444410000000000000000000000000000000000000000000100000000000000000000000000000000000000000000000001
6666666666661000000000000000000000000000000000000000000004444441000000000000000000000000000000000000000001000000000000000000000000000000000000000000000000001
6666666666661000000000000000000000000000000000000000000044444444100000000000000000000000000000000000000010000000000000000000000000000000000000000000000000001
6666666666661000000000000000000000000000000000000000000444444444410000000000000000000000000000000000000100000000000000000000000000000000000000000000000000001
6666666666661000000000000000000000000000000000000000004444444444441000000000000000000000000000000000001000000000000000000000000000000000000000000000000000001
6666666666661000000000000000000000000000000000000000044444444444444100000000000000000000000000000000010000000000000000000000000000000000000000000000000000001
6666666666661000000000000000000000000000000000000000444444444444444410000000000000000000000000000000100000000000000000000000000000000000000000000000000000001
6666666666661000000000000000000000000000000000000004444444444444444441000000000000000000000000000001000000000000000000000000000000000000000000000000000000001
6666666666661000000000000000000000000000000000000044444444444444444444100000000000000000000000000010000000000000000000000000000000000000000000000000000000001
6666666666661000000000000000000000000000000000000444444444444444444444410000000000000000000000000100000000000000000000000000000000000000000000000000000000001
6666666666661000000000000000000000000000000000004444444444444444444444441000000000000000000000001000000000000000000000000000000000000000000000000000000000001
6666666666661000000000000000000000000000000000044444444444444444444444444100000000000000000000010000000000000000000000000000000000000000000000000000000000001
6666666666661000000000000000000000000000000000444444444444444444444444444410000000000000000000100000000000000000000000000000000000000000000000000000000000001
6666666666661000000000000000000000000000000004444444444444444444444444444441000000000000000001000000000000000000000000000000000000000000000000000000000000001
6666666666661000000000000000000000000000000044444444444444444444444444444444100000000000000010000000000000000000000000000000000000000000000000000000000000001
6666666666661000000000000000000000000000000444444444444444444444444444444444410000000000000100000000000000000000000000000000000000000000000000000000000000001
6666666666661000000000000000000000000000004444444444444444444444444444444444441000000000001000000000000000000000000000000000000000000000000000000000000000001
6666666666661000000000000000000000000000044444444444444444444444444444444444444100000000010000000000000000000000000000000000000000000000000000000000000000001
6666666666661000000000000000000000000000444444444444444444444444444444444444444410000000100000000000000000000000000000000000000000000000000000000000000000001
6666666666661000000000000000000000000004444444444444444444444444444444444444444441000001000000000000000000000000000000000000000000000000000000000000000000001
6666666666661000000000000000000000000044444444444444444444444444444444444444444444100010000000000000000000000000000000000000000000000000000000000000000000001
6666666666661000000000000000000000000444444444444444444444444444444444444444444444410100000000000000000000000000000000000000000000000000000000000000000000001
6666666666661000000000000000000000004444444444444444444444444444444444444444444444441000000000000000000000000000000000000000000000005000000000000000000000001
6666666666661000000000000000000000044444444444444444444444444444444444444444444444410000000000000000000000000000000000000000000000000000000000000000000000001
6666666666661000000000000000000000444444444444444444444444444444444444444444444444100000000000000000000000000000000000000000000000000000000000000000000000001
6666666666661000000000000000000004444444444444444444444444444444444444444444444441000000000000000000000000000000000000000000000000000000000000000000000000001
6666666666661000000000000000000044444444444444444444444444444444444444444444444410000000000000000000000000000000000000000000000000000000000000000000000000001
6666666666661000000000000000000444444444444444444444444444444444444444444444444100000000000000000000000000000000000000000000000000000000000000000000000000001
6666666666661000000000000000004444444444444444444444444444444444444444444444441000000000000000000000000000000000000000000000000000000000000000000000000000001
6666666666661000000000000000044444444444444444444444444444444444444444444444410000000000000000000000000000000000000000000000000000000000000000000000000000001
6666666666661000000000000000444444444444444444444444444444444444444444444444100000000000000000000000000000000000000000000000000000000000000000000000000000001
6666666666661000000000000004444444444444444444444444444444444444444444444441000000000000000000000000000000000000000000000000000000000000000000000000000000001
6666666666661000000000000044444444444444444444444444444444444444444444444410000000000000000000000000000000000000000000000000000000000000000000000000000000001
6666666666661000000000000444444444444444444444444444444444444444444444444100000000000000000000000000000000000000000000000000000000000000000000000000000000001
6666666666661000000000004444444444444444444444444444444444444444444444441000000000000000000000000000000000000000000000000000000000000000000000000000000000001
6666666666661000000000044444444444444444444444444444444444444444444444410000000000000000000000000000000000000000000000000000000000000000000000000000000000001
6666666666661000000000444444444444444444444444444444444444444444444444100000000000000000000000000000000000000000000000000000000000000000000000000000000000001
6666666666661000000004444444444444444444444444444444444444444444444441000000000000000000000000000000000000000000000000000000000000000000000000000000000000001
6666666666661000000044444444444444444444444444444444444444444444444410000000000000000000000000000000000000000000000000000000000000000000000000000000000000001
6666666666661000000444444444444444444444444444444444444444444444444100000000000000000000000000000000000000000000000000000000000000000000000000000000000000001
6666666666661000004444444444444444444444444444444444444444444444441000000000000000000000000000000000000000000000000000000000000000000000000000000000000000001
6666666666661000044444444444444444444444444444444444444444444444410000000000000000000000000000000000000000000000000000000000000000000000000000000000000000001
6666666666661000444444444444444444444444444444444444444444444444100000000000000000000000000000000000000000000000000000000000000000000000000000000000000000001
6666666666661004444444444444444444444444444444444444444444444441000000000000000000000000000000000000000000000000000000000000000000000000000000000000000000001
6666666666661044444444444444444444444444444444444444444444444410000000000000000000000000000000000000000000000000000000000000000000000000000000000000000000001
6666666666661444444444444444444444444444444444444444444444444100000000000000000000000000000000000000000000000000000000000000000000000000000000000000000000001
6666666666661111111111111111111111111111111111111111111111111000000000000000000000000000000000000000000000001111111111111111111111111111111111111111111111111
6666666666666666666666666666666666666666666666666666666666666100000000000000000000000000000000000000000000016666666666666666666666666666666666666666666666666
6666666666666666666666666666666666666666666666666666666666666610000000000000000000000000000000000000000000166666666666666666666666666666666666666666666666666
6666666666666666666666666666666666666666666666666666666666666661000000000000000000000000000000000000000001666666666666666666666666666666666666666666666666666
6666666666666666666666666666666666666666666666666666666666666666100000000000000000000000000000000000000016666666666666666666666666666666666666666666666666666
6666666666666666666666666666666666666666666666666666666666666666610000000000000000000000000000000000000166666666666666666666666666666666666666666666666666666
6666666666666666666666666666666666666666666666666666666666666666661000000000000000000000000000000000001666666666666666666666666666666666666666666666666666666
6666666666666666666666666666666666666666666666666666666666666666666100000000000000000000000000000000016666666666666666666666666666666666666666666666666666666
6666666666666666666666666666666666666666666666666666666666666666666610000000000000000000000000000000166666666666666666666666666666666666666666666666666666666
6666666666666666666666666666666666666666666666666666666666666666666661000000000000000000000000000001666666666666666666666666666666666666666666666666666666666
6666666666666666666666666666666666666666666666666666666666666666666666100000000000000000000000000016666666666666666666666666666666666666666666666666666666666
6666666666666666666666666666666666666666666666666666666666666666666666610000000000000000000000000166666666666666666666666666666666666666666666666666666666666
6666666666666666666666666666666666666666666666666666666666666666666666661000000000000000000000001666666666666666666666666666666666666666666666666666666666666
6666666666666666666666666666666666666666666666666666666666666666666666666100000000000000000000016666666666666666666666666666666666666666666666666666666666666
6666666666666666666666666666666666666666666666666666666666666666666666666610000000000000000000166666666666666666666666666666666666666666666666666666666666666
6666666666666666666666666666666666666666666666666666666666666666666666666661000000000000000001666666666666666666666666666666666666666666666666666666666666666
6666666666666666666666666666666666666666666666666666666666666666666666666666100000000000000016666666666666666666666666666666666666666666666666666666666666666
6666666666666666666666666666666666666666666666666666666666666666666666666666610000000000000166666666666666666666666666666666666666666666666666666666666666666
6666666666666666666666666666666666666666666666666666666666666666666666666666661000000000001666666666666666666666666666666666666666666666666666666666666666666
6666666666666666666666666666666666666666666666666666666666666666666666666666666100000000016666666666666666666666666666666666666666666666666666666666666666666
6666666666666666666666666666666666666666666666666666666666666666666666666666666610000000166666666666666666666666666666666666666666666666666666666666666666666
6666666666666666666666666666666666666666666666666666666666666666666666666666666661000001666666666666666666666666666666666666666666666666666666666666666666666
6666666666666666666666666666666666666666666666666666666666666666666666666666666666100016666666666666666666666666666666666666666666666666666666666666666666666
6666666666666666666666666666666666666666666666666666666666666666666666666666666666610166666666666666666666666666666666666666666666666666666666666666666666666
6666666666666666666666666666666666666666666666666666666666666666666666666666666666661666666666666666666666666666666666666666666666666666666666666666666666666
6666666666666666666666666666666666666666666666666666666666666666666666666666666666666666666666666666666666666666666666666666666666666666666666666666666666666
6666666666666666666666666666666666666666666666666666666666666666666666666666666666666666666666666666666666666666666666666666666666666666666666666666666666666
6666666666666666666666666666666666666666666666666666666666666666666666666666666666666666666666666666666666666666666666666666666666666666666666666666666666666
6666666666666666666666666666666666666666666666666666666666666666666666666666666666666666666666666666666666666666666666666666666666666666666666666666666666666
6666666666666666666666666666666666666666666666666666666666666666666666666666666666666666666666666666666666666666666666666666666666666666666666666666666666666
6666666666666666666666666666666666666666666666666666666666666666666666666666666666666666666666666666666666666666666666666666666666666666666666666666666666666
6666666666666666666666666666666666666666666666666666666666666666666666666666666666666666666666666666666666666666666666666666666666666666666666666666666666666
6666666666666666666666666666666666666666666666666666666666666666666666666666666666666666666666666666666666666666666666666666666666666666666666666666666666666
6666666666666666666666666666666666666666666666666666666666666666666666666666666666666666666666666666666666666666666666666666666666666666666666666666666666666
6666666666666666666666666666666666666666666666666666666666666666666666666666666666666666666666666666666666666666666666666666666666666666666666666666666666666
6666666666666666666666666666666666666666666666666666666666666666666666666666666666666666666666666666666666666666666666666666666666666666666666666666666666666
6666666666666666666666666666666666666666666666666666666666666666666666666666666666666666666666666666666666666666666666666666666666666666666666666666666666666
